يتبع	تبع
يكون	كان
يعرف	عرف
يعمل	عمل
يقول	قال
يلعب	لعب
يستخدم	إستخدم
يقوم	قام	
يبلغ	بلغ	
يجد	وجد
يعد	عد
يظهر	ظهر
يؤدي	أدي
يعني	عني
يعود	عود
يحدث	حدث
يزيد	زيد
يحتوي	احتوى
ينتمي	انتمى
يطلق	طلق