تعاون	بالتعاون
يمن	باليمن
جمهورية	بالجمهورية
قرب	بالقرب
رغم	بالرغم
فعل	بالفعل
كامل	بالكامل
إضافة	بالإضافة
عربية	بالعربية
نادي	بالنادي
عمل	بالعمل
مدينة	بالمدينة
ذكر	بالذكر
تالي	بالتالي
لون	باللون
مغرب	بالمغرب
ولايات	بالولايات
منطقة	بالمنطقة
اشتراك	بالاشتراك
ضربة	بالضربة