اشتراك	الاشتراك
إضافة	الإضافة
أمر	الأمر
باب	الباب
بيت	البيت
تالي	التالي
تعاون	التعاون
ثقافة	الثقافة
جامعة	الجامعة
جبل	الجبل
جمهورية	الجمهورية
جيش	الجيش
حدود	الحدود
ذكر	الذكر
رغم	الرغم
ضربة	الضربة
عربية	العربية
عمل	العمل
فعل	الفعل
قرب	القرب
كامل	الكامل
لون	اللون
مدرسة	المدرسة
مدينة	المدينة
مغرب	المغرب
منطقة	المنطقة
نادي	النادي
ولايات	الولايات
يمن	اليمن