مسيرتها	مسيرته
طولها	طوله
عمرها	عمره
مساحتها	مساحته
اسمها	اسمه
مقرها	مقره
حياتها	حياته
زوجها	زوجه
حينها	حينه
كونها	كونه
كتبها	كتبه
وقتها	وقته
والدها	والده
اعتبارها	اعتباره
تاريخها	تاريخه
وضعها	وضعه
أهلها	أهله
ذاتها	ذاته
معظمها	معظمه
أعمالها	أعماله