مسيرة	مسيرتها
طول	طولها
عمر	عمرها
مساحة	مساحتها
اسم	اسمها
مقر	مقرها
حياة	حياتها
زوج	زوجها
حين	حينها
كون	كونها
كتب	كتبها
وقت	وقتها
والد	والدها
اعتبار	اعتبارها
تاريخ	تاريخها
وضع	وضعها
أهل	أهلها
ذات	ذاتها
معظم	معظمها
أعمال	أعمالها