روابط	وروابط
مساحتها	ومساحتها
سلم	وسلم
نصف	ونصف
عدم	وعدم
عدد	وعدد
العلوم	والعلوم
رئيس	ورئيس
المعلومات	والمعلومات
الدراسات	والدراسات
التعليم	والتعليم
الشيخ	والشيخ
العمل	والعمل
الذين	والذين
الاجتماعية	والاجتماعية
الثقافة	والثقافة
العديد	والعديد
الولايات	والولايات
الجماعة	والجماعة
الخدمات	والخدمات
النشر	والنشر