مسيرة	مسيرته
طول	طوله
عمر	عمره
مساحة	مساحته
اسم	اسمه
مقر	مقره
حياة	حياته
زوجة	زوجته
حين	حينه
كون	كونه
كتب	كتبه
وقت	وقته
والد	والده
اعتبار	اعتباره
تاريخ	تاريخه
وضع	وضعه
أهل	أهله
ذات	ذاته
معظم	معظمه
أعمال	أعماله