يعتبر	تعتبره
يستخدم	تستخدمه
يلعب	تلعبه
يحتوي	تحتويه
يريد	تريده
يحتاج	تحتاجه
يعطي	تعطيه
يساعد	تساعده
يأخذ	تأخذه
يجد	تجده
يمتلك	تمتلكه
يضع	تضعه
يشغل	تشغله
يحب	تحبه
يقود	تقوده
يدفع	تدفعه
يمارس	تمارسه
يفعل	تفعله
يواجه	تواجهه
يرتدي	ترتديه
يدير	تديره
يسمي	تسميه
يخبر	تخبره
