يعتبر	يعتبرها
يستخدم	يستخدمها
يعني	يعنيها
يحتوي	يحتويها
يجعل	يجعلها
ينتج	ينتجها
يريد	يريدها
يحتاج	يحتاجها
يعطي	يعطيها
يساعد	يساعدها
يأخذ	يأخذها
يجد	يجدها
يمتلك	يمتلكها
يمنع	يمنعها
يشغل	يشغلها
يحب	يحبها
يدعم	يدعمها
يدفع	يدفعها
يمارس	يمارسها
يواجه	يواجهها
يرتدي	يرتديها
يمنح	يمنحها
يدير	يديرها
يسمي	يسميها
يخبر	يخبرها
