يعتبر	يعتبره
يستخدم	يستخدمه
يعني	يعنيه
يحتوي	يحتويه
يجعل	يجعله
يأتي	يأتيه
ينتج	ينتجه
يحتاج	يحتاجه
يعطي	يعطيه
يساعد	يساعده
يأخذ	يأخذه
يجد	يجده
يمتلك	يمتلكه
يمنع	يمنعه
يضع	يضعه
يشغل	يشغله
يدعم	يدعمه
يقود	يقوده
يدفع	يدفعه
يمارس	يمارسه
يفعل	يفعله
يواجه	يواجهه
يدير	يديره
