يعتبر	تعتبر
يستخدم	تستخدم
يلعب	تلعب
يحتوي	تحتوي
يأتي	تأتي
ينتج	تنتج
يريد	تريد
يحتاج	تحتاج
يعطي	تعطي
يساعد	تساعد
يأخذ	تأخذ
يجد	تجد
يمتلك	تمتلك
يمنع	تمنع
يضع	تضع
يشغل	تشغل
يحب	تحب
يدعم	تدعم
يقود	تقود
يدفع	تدفع
يمارس	تمارس
يفعل	تفعل
يواجه	تواجه
يرتدي	ترتدي
يمنح	تمنح
يدير	تدير
يسمي	تسمي
يخبر	تخبر
