يعتبر	تعتبرها
يستخدم	تستخدمها
يعني	تعنيها
يجعل	تجعلها
يأتي	تأتيها
يريد	تريدها
يحتاج	تحتاجها
يعطي	تعطيها
يساعد	تساعدها
يأخذ	تأخذها
يجد	تجدها
يمتلك	تمتلكها
يمنع	تمنعها
يضع	تضعها
يشغل	تشغلها
يحب	تحبها
يدعم	تدعمها
يقود	تقودها
يدفع	تدفعها
يمارس	تمارسها
يفعل	تفعلها
يواجه	تواجهها
يرتدي	ترتديها
يمنح	تمنحها
يسمي	تسميها
يخبر	تخبرها
