يعتبرها	يعتبره
يستخدمها	يستخدمه
يعنيها	يعنيه
يجعلها	يجعله
يأتيها	يأتيه
ينتجها	ينتجه
يريدها	يريده
يحتاجها	يحتاجه
يعطيها	يعطيه
يساعدها	يساعده
يأخذها	يأخذه
يجدها	يجده
يمتلكها	يمتلكه
يمنعها	يمنعه
يربطها	يربطه
يضعها	يضعه
يشغلها	يشغله
يحبها	يحبه
يدعمها	يدعمه
يقودها	يقوده
يدفعها	يدفعه
يمارسها	يمارسه
يرتديها	يرتديه
يمنحها	يمنحه
يديرها	يديره
يسميها	يسميه
يخبرها	يخبره
يعلوها	يعلوه
