يعتبرها	تعتبره
يستخدمها	تستخدمه
يلعبها	تلعبه
ينتجها	تنتجه
يريدها	تريده
يحتاجها	تحتاجه
يعطيها	تعطيه
يأخذها	تأخذه
يجدها	تجده
يمتلكها	تمتلكه
يضعها	تضعه
يشغلها	تشغله
يحبها	تحبه
يدعمها	تدعمه
يقودها	تقوده
يدفعها	تدفعه
يمارسها	تمارسه
يفعلها	تفعله
يواجهها	تواجهه
يرتديها	ترتديه
يمنحها	تمنحه
يديرها	تديره
يسميها	تسميه
