يعتبره	تعتبرها
يستخدمه	تستخدمها
يلعبه	تلعبها
يعنيه	تعنيها
يحتويه	تحتويها
يجعله	تجعلها
يأتيه	تأتيها
ينتجه	تنتجها
يريده	تريدها
يحتاجه	تحتاجها
يعطيه	تعطيها
يساعده	تساعدها
يأخذه	تأخذها
يجده	تجدها
يمتلكه	تمتلكها
يمنعه	تمنعها
يربطه	تربطها
يضعه	تضعها
يشغله	تشغلها
يحبه	تحبها
يدعمه	تدعمها
يقوده	تقودها
يدفعه	تدفعها
يمارسه	تمارسها
يفعله	تفعلها
يواجهه	تواجهها
يرتديه	ترتديها
يمنحه	تمنحها
يديره	تديرها
يسميه	تسميها
يتوسطه	تتوسطها
يخبره	تخبرها
يعلوه	تعلوها
