يعتبره	تعتبر
يستخدمه	تستخدم
يلعبه	تلعب
يحتويه	تحتوي
يأتيه	تأتي
ينتجه	تنتج
يريده	تريد
يحتاجه	تحتاج
يعطيه	تعطي
يساعده	تساعد
يأخذه	تأخذ
يجده	تجد
يمتلكه	تمتلك
يمنعه	تمنع
يربطه	تربط
يضعه	تضع
يشغله	تشغل
يحبه	تحب
يدعمه	تدعم
يقوده	تقود
يدفعه	تدفع
يمارسه	تمارس
يفعله	تفعل
يواجهه	تواجه
يرتديه	ترتدي
يديره	تدير
يسميه	تسمي
يخبره	تخبر
