يعتبرها	تعتبرها
يستخدمها	تستخدمها
يلعبها	تلعبها
يعنيها	تعنيها
يأتيها	تأتيها
ينتجها	تنتجها
يريدها	تريدها
يحتاجها	تحتاجها
يعطيها	تعطيها
يساعدها	تساعدها
يأخذها	تأخذها
يجدها	تجدها
يمتلكها	تمتلكها
يضعها	تضعها
يشغلها	تشغلها
يحبها	تحبها
يدعمها	تدعمها
يقودها	تقودها
يدفعها	تدفعها
يمارسها	تمارسها
يفعلها	تفعلها
يواجهها	تواجهها
يرتديها	ترتديها
يسميها	تسميها
يخبرها	تخبرها
