يعتبرها	تعتبر
يستخدمها	تستخدم
يلعبها	تلعب
يحتويها	تحتوي
ينتجها	تنتج
يريدها	تريد
يحتاجها	تحتاج
يعطيها	تعطي
يأخذها	تأخذ
يجدها	تجد
يمتلكها	تمتلك
يمنعها	تمنع
يضعها	تضع
يشغلها	تشغل
يحبها	تحب
يدعمها	تدعم
يقودها	تقود
يدفعها	تدفع
يمارسها	تمارس
يفعلها	تفعل
يواجهها	تواجه
يرتديها	ترتدي
يديرها	تدير
