يعتبره	تعتبره
يستخدمه	تستخدمه
يلعبه	تلعبه
يحتويه	تحتويه
ينتجه	تنتجه
يريده	تريده
يحتاجه	تحتاجه
يعطيه	تعطيه
يساعده	تساعده
يأخذه	تأخذه
يجده	تجده
يمتلكه	تمتلكه
يضعه	تضعه
يشغله	تشغله
يحبه	تحبه
يدعمه	تدعمه
يقوده	تقوده
يمارسه	تمارسه
يفعله	تفعله
يواجهه	تواجهه
يرتديه	ترتديه
يديره	تديره
يسميه	تسميه
يتوسطه	تتوسطه
يخبره	تخبره
