تعتبرها	تعتبره
تستخدمها	تستخدمه
تعنيها	تعنيه
تجعلها	تجعله
تأتيها	تأتيه
تريدها	تريده
تحتاجها	تحتاجه
تعطيها	تعطيه
تساعدها	تساعده
تأخذها	تأخذه
تجدها	تجده
تمتلكها	تمتلكه
تمنعها	تمنعه
تربطها	تربطه
تضعها	تضعه
تحبها	تحبه
تدعمها	تدعمه
تقودها	تقوده
تدفعها	تدفعه
تمارسها	تمارسه
تواجهها	تواجهه
ترتديها	ترتديه
تمنحها	تمنحه
تديرها	تديره
تسميها	تسميه
تتوسطها	تتوسطه
تخبرها	تخبره
تعلوها	تعلوه
