تعتبر	تعتبره
تستخدم	تستخدمه
تعني	تعنيه
تحتوي	تحتويه
تجعل	تجعله
تأتي	تأتيه
تنتج	تنتجه
تعطي	تعطيه
تساعد	تساعده
تأخذ	تأخذه
تجد	تجده
تمتلك	تمتلكه
تمنع	تمنعه
تربط	تربطه
تضع	تضعه
تشغل	تشغله
تحب	تحبه
تدعم	تدعمه
تقود	تقوده
تدفع	تدفعه
تواجه	تواجهه
تمنح	تمنحه
تخبر	تخبره
