تعتبر	تعتبرها
تستخدم	تستخدمها
تلعب	تلعبها
تعني	تعنيها
تحتوي	تحتويها
تجعل	تجعلها
تأتي	تأتيها
تنتج	تنتجها
تحتاج	تحتاجها
تعطي	تعطيها
تساعد	تساعدها
تأخذ	تأخذها
تمتلك	تمتلكها
تمنع	تمنعها
تضع	تضعها
تشغل	تشغلها
تدعم	تدعمها
تقود	تقودها
تدفع	تدفعها
تمارس	تمارسها
تواجه	تواجهها
تمنح	تمنحها
تخبر	تخبرها
